['.', '.', '.', '.', '.', '.', '.', '.', '.', '.', '.', '.', '.', '.', '.', '.', '.', '.', '.', '.', '.', '.', '.', '.', '.', '.', '.', '.', '.', '.', '.', '.', '.', '.', '.', '.', '#', '#', '#', '#', '#', '#', '#', '.', '.', '.', '.', '.', '.', '.', '.', '.', '.']
['.', '.', '.', '.', '.', '.', '.', '.', '.', '.', '.', '.', '.', '.', '.', '.', '.', '.', '.', '.', '.', '.', '.', '.', '.', '.', '.', '.', '.', '.', '.', '.', '.', '.', '.', '.', '#', '.', '.', '.', '.', '.', '#', '.', '.', '.', '.', '.', '.', '.', '.', '.', '.']
['.', '.', '.', '.', '.', '.', '.', '.', '.', '.', '.', '.', '.', '.', '.', '.', '.', '.', '.', '.', '.', '.', '.', '.', '.', '.', '.', '.', '.', '.', '.', '.', '.', '.', '.', '.', '#', '.', '.', '.', '.', '.', '#', '.', '.', '.', '.', '.', '.', '.', '.', '.', '.']
['.', '.', '.', '.', '.', '.', '.', '.', '.', '.', '.', '.', '.', '.', '.', '.', '.', '.', '.', '.', '.', '.', '.', '.', '.', '.', '.', '.', '.', '.', '.', '.', '.', '.', '.', '.', '#', '.', '.', '.', '.', '.', '#', '.', '.', '.', '.', '.', '.', '.', '.', '.', '.']
['.', '.', '.', '.', '.', '.', '.', '.', '.', '.', '.', '.', '.', '.', '.', '.', '.', '.', '.', '.', '.', '.', '.', '.', '.', '.', '.', '.', '.', '.', '.', '.', '.', '.', '.', '.', '#', '.', '.', '.', '.', '.', '#', '.', '.', '.', '.', '.', '.', '.', '.', '.', '.']
['.', '.', '.', '.', '.', '.', '.', '.', '.', '.', '.', '.', '.', '.', '.', '.', '.', '.', '.', '.', '.', '.', '.', '.', '.', '.', '.', '.', '.', '.', '.', '.', '.', '.', '.', '.', '#', '.', '.', '.', '.', '.', '#', '.', '.', '.', '.', '.', '.', '.', '.', '.', '.']
['.', '.', '.', '.', '.', '.', '.', '.', '.', '.', '.', '.', '.', '.', '.', '.', '.', '.', '.', '.', '.', '.', '.', '.', '.', '.', '.', '.', '.', '.', '.', '.', '.', '.', '.', '.', '#', '.', '.', '.', '.', '.', '#', '.', '.', '.', '.', '.', '.', '.', '.', '.', '.']
['.', '.', '.', '.', '.', '.', '.', '.', '.', '.', '.', '.', '.', '.', '.', '.', '.', '.', '.', '.', '.', '.', '.', '.', '.', '.', '.', '.', '.', '.', '.', '.', '.', '.', '.', '.', '#', '.', '.', '.', '.', '.', '#', '.', '.', '.', '.', '.', '.', '.', '.', '.', '.']
['.', '.', '.', '.', '.', '.', '.', '.', '.', '.', '.', '.', '.', '.', '.', '.', '.', '.', '.', '.', '.', '.', '.', '.', '.', '.', '.', '.', '.', '.', '.', '.', '.', '.', '#', '#', '#', '#', '#', '#', '#', '#', '#', '.', '.', '.', '.', '.', '.', '.', '.', '.', '.']
['.', '.', '.', '.', '.', '.', '.', '.', '.', '.', '.', '.', '.', '.', '.', '.', '.', '.', '.', '.', '.', '.', '.', '.', '.', '.', '.', '.', '.', '.', '.', '.', '.', '.', '#', '.', '#', '.', '.', '.', '.', '.', '.', '.', '.', '.', '.', '.', '.', '.', '.', '.', '.']
['.', '.', '.', '.', '.', '.', '.', '.', '.', '.', '.', '.', '.', '.', '.', '.', '.', '.', '.', '.', '.', '.', '.', '.', '.', '.', '.', '.', '#', '#', '#', '#', '#', '#', '#', '#', '#', '.', '.', '.', '.', '.', '.', '.', '.', '.', '.', '.', '.', '.', '.', '.', '.']
['.', '.', '.', '.', '.', '.', '.', '.', '.', '.', '.', '.', '.', '.', '.', '.', '.', '.', '.', '.', '.', '.', '.', '.', '.', '.', '.', '.', '#', '.', '.', '.', '.', '.', '#', '.', '.', '.', '.', '.', '.', '.', '.', '.', '.', '.', '.', '.', '.', '.', '.', '.', '.']
['.', '.', '.', '.', '.', '.', '.', '.', '.', '.', '.', '.', '.', '.', '.', '.', '.', '.', '.', '.', '.', '.', '.', '.', '.', '.', '.', '.', '#', '.', '.', '.', '.', '.', '#', '.', '.', '.', '.', '.', '.', '.', '.', '.', '.', '.', '.', '.', '.', '.', '.', '.', '.']
['.', '.', '.', '.', '.', '.', '.', '.', '.', '.', '.', '.', '.', '.', '.', '.', '.', '.', '.', '.', '.', '.', '.', '.', '.', '.', '.', '.', '#', '.', '.', '.', '.', '.', '#', '.', '.', '.', '.', '.', '.', '.', '.', '.', '.', '.', '.', '.', '.', '.', '.', '.', '.']
['.', '.', '.', '.', '.', '.', '.', '.', '.', '.', '.', '.', '.', '.', '.', '.', '.', '.', '.', '.', '.', '.', '.', '.', '.', '.', '#', '#', '#', '#', '#', '#', '#', '#', '#', '.', '.', '.', '.', '.', '.', '.', '.', '.', '.', '.', '.', '.', '.', '.', '.', '.', '.']
['.', '.', '.', '.', '.', '.', '.', '.', '.', '.', '.', '.', '.', '.', '.', '.', '.', '.', '.', '.', '.', '.', '.', '.', '.', '.', '#', '.', '#', '.', '.', '.', '.', '.', '.', '.', '.', '.', '.', '.', '.', '.', '.', '.', '.', '.', '.', '.', '.', '.', '.', '.', '.']
['.', '.', '.', '.', '.', '.', '.', '.', '.', '.', '.', '.', '.', '.', '.', '.', '.', '.', '.', '.', '.', '.', '.', '.', '.', '.', '#', '.', '#', '.', '.', '.', '.', '.', '.', '.', '.', '.', '.', '.', '.', '.', '.', '.', '.', '.', '.', '.', '.', '.', '.', '.', '.']
['.', '.', '.', '.', '.', '.', '.', '.', '.', '.', '.', '.', '.', '.', '.', '.', '.', '.', '.', '.', '.', '.', '.', '.', '.', '.', '#', '.', '#', '.', '.', '.', '.', '.', '.', '.', '.', '.', '.', '.', '.', '.', '.', '.', '.', '.', '.', '.', '.', '.', '.', '.', '.']
['.', '.', '.', '.', '.', '.', '.', '.', '.', '.', '.', '.', '.', '.', '.', '.', '.', '.', '.', '.', '.', '.', '.', '.', '.', '.', '#', '.', '#', '#', '#', '#', '#', '#', '#', '#', '#', '#', '#', '.', '.', '.', '.', '.', '.', '.', '.', '.', '.', '.', '.', '.', '.']
['.', '.', '.', '.', '.', '.', '.', '.', '.', '.', '.', '.', '.', '.', '.', '.', '.', '.', '.', '.', '.', '.', '.', '.', '.', '.', '#', '.', '.', '.', '.', '.', '.', '.', '.', '.', '.', '.', '#', '.', '.', '.', '.', '.', '.', '.', '.', '.', '.', '.', '.', '.', '.']
['#', '#', '#', '#', '#', '#', '#', '#', '#', '.', '#', '#', '#', '#', '#', '#', '#', '#', '#', '#', '^', '.', '.', '.', '.', '.', '#', '.', '.', '.', '.', '.', '.', '.', '#', '#', '#', '#', '#', '#', '#', '#', '#', '.', '.', '.', '.', '.', '.', '.', '.', '.', '.']
['#', '.', '.', '.', '.', '.', '.', '.', '#', '.', '#', '.', '.', '.', '.', '.', '.', '.', '.', '.', '.', '.', '.', '.', '.', '.', '#', '.', '.', '.', '.', '.', '.', '.', '#', '.', '.', '.', '#', '.', '.', '.', '#', '.', '.', '.', '.', '.', '.', '.', '.', '.', '.']
['#', '.', '.', '.', '.', '.', '.', '.', '#', '.', '#', '.', '.', '.', '.', '.', '.', '.', '.', '.', '.', '.', '.', '.', '.', '.', '#', '.', '.', '.', '.', '.', '.', '.', '#', '.', '.', '.', '#', '.', '.', '.', '#', '.', '.', '.', '.', '.', '.', '.', '.', '.', '.']
['#', '.', '.', '.', '.', '.', '.', '.', '#', '.', '#', '.', '.', '.', '.', '.', '.', '.', '.', '.', '.', '.', '.', '.', '.', '.', '#', '.', '.', '.', '.', '.', '.', '.', '#', '.', '.', '.', '#', '.', '.', '.', '#', '.', '.', '.', '.', '.', '.', '.', '.', '.', '.']
['#', '.', '.', '.', '.', '.', '.', '.', '#', '.', '#', '.', '.', '.', '.', '.', '.', '.', '.', '.', '.', '.', '.', '.', '.', '.', '#', '#', '#', '#', '#', '#', '#', '.', '#', '.', '.', '.', '#', '.', '.', '.', '#', '.', '.', '.', '.', '.', '.', '.', '.', '.', '.']
['#', '.', '.', '.', '.', '.', '.', '.', '#', '.', '#', '.', '.', '.', '.', '.', '.', '.', '.', '.', '.', '.', '.', '.', '.', '.', '.', '.', '.', '.', '.', '.', '#', '.', '#', '.', '.', '.', '#', '.', '.', '.', '#', '.', '.', '.', '.', '.', '.', '.', '.', '.', '.']
['#', '#', '#', '#', '#', '#', '#', '#', '#', '#', '#', '.', '.', '.', '.', '.', '.', '.', '.', '.', '.', '.', '.', '.', '.', '.', '.', '.', '.', '.', '.', '.', '#', '.', '#', '.', '.', '.', '#', '#', '#', '#', '#', '#', '#', '.', '.', '.', '.', '.', '.', '.', '.']
['.', '.', '.', '.', '.', '.', '.', '.', '#', '.', '.', '.', '.', '.', '.', '.', '.', '.', '.', '.', '.', '.', '.', '.', '.', '.', '.', '.', '.', '.', '.', '.', '#', '.', '#', '.', '.', '.', '.', '.', '.', '.', '#', '.', '#', '.', '.', '.', '.', '.', '.', '.', '.']
['.', '.', '.', '.', '.', '.', '.', '.', '#', '#', '#', '#', '#', '#', '#', '.', '.', '.', '.', '.', '.', '.', '.', '.', '.', '.', '.', '.', '.', '.', '.', '.', '#', '.', '#', '.', '.', '.', '.', '.', '.', '.', '#', '#', '#', '#', '#', '#', '#', '#', '#', '#', '#']
['.', '.', '.', '.', '.', '.', '.', '.', '.', '.', '.', '.', '.', '.', '#', '.', '.', '.', '.', '.', '.', '.', '.', '.', '.', '.', '.', '.', '.', '.', '.', '.', '#', '.', '#', '.', '.', '.', '.', '.', '.', '.', '.', '.', '#', '.', '.', '.', '.', '.', '.', '.', '#']
['.', '.', '.', '.', '.', '.', '.', '.', '.', '.', '.', '.', '.', '.', '#', '.', '.', '.', '.', '.', '.', '.', '.', '.', '#', '#', '#', '#', '#', '#', '#', '#', '#', '#', '#', '.', '.', '.', '.', '.', '.', '.', '.', '.', '#', '.', '.', '.', '.', '.', '.', '.', '#']
['.', '.', '.', '.', '.', '.', '.', '.', '.', '.', '.', '.', '.', '.', '#', '.', '.', '.', '.', '.', '.', '.', '.', '.', '#', '.', '.', '.', '.', '.', '.', '.', '#', '.', '.', '.', '.', '.', '.', '.', '.', '.', '.', '.', '#', '.', '.', '.', '.', '.', '.', '.', '#']
['.', '.', '.', '.', '.', '.', '.', '.', '.', '.', '.', '.', '.', '.', '#', '.', '.', '.', '.', '.', '.', '.', '.', '.', '#', '.', '.', '.', '.', '.', '.', '.', '#', '.', '.', '.', '.', '.', '.', '.', '.', '.', '.', '.', '#', '.', '.', '.', '.', '.', '.', '.', '#']
['.', '.', '.', '.', '.', '.', '.', '.', '.', '.', '.', '.', '.', '.', '#', '.', '.', '.', '.', '.', '.', '.', '.', '.', '#', '.', '.', '.', '.', '.', '.', '.', '#', '.', '.', '.', '.', '.', '.', '.', '.', '.', '.', '.', '#', '.', '.', '.', '.', '.', '.', '.', '#']
['.', '.', '.', '.', '.', '.', '.', '.', '.', '.', '.', '.', '.', '.', '#', '.', '.', '.', '.', '.', '.', '.', '.', '.', '#', '.', '.', '.', '.', '.', '.', '.', '#', '#', '#', '#', '#', '#', '#', '#', '#', '#', '#', '.', '#', '#', '#', '#', '#', '#', '#', '#', '#']
['.', '.', '.', '.', '.', '.', '.', '.', '.', '.', '.', '.', '.', '.', '#', '.', '.', '.', '.', '.', '.', '.', '.', '.', '#', '.', '.', '.', '.', '.', '.', '.', '.', '.', '.', '.', '.', '.', '.', '.', '.', '.', '#', '.', '.', '.', '.', '.', '.', '.', '.', '.', '.']
['.', '.', '.', '.', '.', '.', '.', '.', '.', '.', '.', '.', '.', '.', '#', '#', '#', '#', '#', '#', '#', '#', '#', '#', '#', '.', '.', '.', '.', '.', '.', '.', '.', '.', '.', '.', '.', '.', '.', '.', '.', '.', '#', '.', '.', '.', '.', '.', '.', '.', '.', '.', '.']
['.', '.', '.', '.', '.', '.', '.', '.', '.', '.', '.', '.', '.', '.', '.', '.', '.', '.', '.', '.', '.', '.', '.', '.', '.', '.', '.', '.', '.', '.', '.', '.', '.', '.', '.', '.', '.', '.', '.', '.', '.', '.', '#', '.', '.', '.', '.', '.', '.', '.', '.', '.', '.']
['.', '.', '.', '.', '.', '.', '.', '.', '.', '.', '.', '.', '.', '.', '.', '.', '.', '.', '.', '.', '.', '.', '.', '.', '.', '.', '.', '.', '.', '.', '.', '.', '.', '.', '.', '.', '#', '#', '#', '#', '#', '#', '#', '#', '#', '.', '.', '.', '.', '.', '.', '.', '.']
['.', '.', '.', '.', '.', '.', '.', '.', '.', '.', '.', '.', '.', '.', '.', '.', '.', '.', '.', '.', '.', '.', '.', '.', '.', '.', '.', '.', '.', '.', '.', '.', '.', '.', '.', '.', '#', '.', '.', '.', '.', '.', '#', '.', '.', '.', '.', '.', '.', '.', '.', '.', '.']
['.', '.', '.', '.', '.', '.', '.', '.', '.', '.', '.', '.', '.', '.', '.', '.', '.', '.', '.', '.', '.', '.', '.', '.', '.', '.', '.', '.', '.', '.', '.', '.', '.', '.', '.', '.', '#', '.', '.', '.', '.', '.', '#', '.', '.', '.', '.', '.', '.', '.', '.', '.', '.']
['.', '.', '.', '.', '.', '.', '.', '.', '.', '.', '.', '.', '.', '.', '.', '.', '.', '.', '.', '.', '.', '.', '.', '.', '.', '.', '.', '.', '.', '.', '.', '.', '.', '.', '.', '.', '#', '.', '.', '.', '.', '.', '#', '.', '.', '.', '.', '.', '.', '.', '.', '.', '.']
['.', '.', '.', '.', '.', '.', '.', '.', '.', '.', '.', '.', '.', '.', '.', '.', '.', '.', '.', '.', '.', '.', '.', '.', '.', '.', '.', '.', '.', '.', '.', '.', '.', '.', '#', '#', '#', '#', '#', '#', '#', '#', '#', '.', '.', '.', '.', '.', '.', '.', '.', '.', '.']
['.', '.', '.', '.', '.', '.', '.', '.', '.', '.', '.', '.', '.', '.', '.', '.', '.', '.', '.', '.', '.', '.', '.', '.', '.', '.', '.', '.', '.', '.', '.', '.', '.', '.', '#', '.', '#', '.', '.', '.', '.', '.', '.', '.', '.', '.', '.', '.', '.', '.', '.', '.', '.']
['.', '.', '.', '.', '.', '.', '.', '.', '.', '.', '.', '.', '.', '.', '.', '.', '.', '.', '.', '.', '.', '.', '.', '.', '.', '.', '.', '.', '#', '#', '#', '#', '#', '#', '#', '#', '#', '.', '.', '.', '.', '.', '.', '.', '.', '.', '.', '.', '.', '.', '.', '.', '.']
['.', '.', '.', '.', '.', '.', '.', '.', '.', '.', '.', '.', '.', '.', '.', '.', '.', '.', '.', '.', '.', '.', '.', '.', '.', '.', '.', '.', '#', '.', '.', '.', '.', '.', '#', '.', '.', '.', '.', '.', '.', '.', '.', '.', '.', '.', '.', '.', '.', '.', '.', '.', '.']
['.', '.', '.', '.', '.', '.', '.', '.', '.', '.', '.', '.', '.', '.', '.', '.', '.', '.', '.', '.', '.', '.', '.', '.', '.', '.', '.', '.', '#', '.', '.', '.', '.', '.', '#', '.', '.', '.', '.', '.', '.', '.', '.', '.', '.', '.', '.', '.', '.', '.', '.', '.', '.']
['.', '.', '.', '.', '.', '.', '.', '.', '.', '.', '.', '.', '.', '.', '.', '.', '.', '.', '.', '.', '.', '.', '.', '.', '.', '.', '.', '.', '#', '.', '.', '.', '.', '.', '#', '.', '.', '.', '.', '.', '.', '.', '.', '.', '.', '.', '.', '.', '.', '.', '.', '.', '.']
['.', '.', '.', '.', '.', '.', '.', '.', '.', '.', '.', '.', '.', '.', '.', '.', '.', '.', '.', '.', '.', '.', '.', '.', '.', '.', '.', '.', '#', '.', '.', '.', '.', '.', '#', '.', '.', '.', '.', '.', '.', '.', '.', '.', '.', '.', '.', '.', '.', '.', '.', '.', '.']
['.', '.', '.', '.', '.', '.', '.', '.', '.', '.', '.', '.', '.', '.', '.', '.', '.', '.', '.', '.', '.', '.', '.', '.', '.', '.', '.', '.', '#', '.', '.', '.', '.', '.', '#', '.', '.', '.', '.', '.', '.', '.', '.', '.', '.', '.', '.', '.', '.', '.', '.', '.', '.']
['.', '.', '.', '.', '.', '.', '.', '.', '.', '.', '.', '.', '.', '.', '.', '.', '.', '.', '.', '.', '.', '.', '.', '.', '.', '.', '.', '.', '#', '.', '.', '.', '.', '.', '#', '.', '.', '.', '.', '.', '.', '.', '.', '.', '.', '.', '.', '.', '.', '.', '.', '.', '.']
['.', '.', '.', '.', '.', '.', '.', '.', '.', '.', '.', '.', '.', '.', '.', '.', '.', '.', '.', '.', '.', '.', '.', '.', '.', '.', '.', '.', '#', '.', '.', '.', '.', '.', '#', '.', '.', '.', '.', '.', '.', '.', '.', '.', '.', '.', '.', '.', '.', '.', '.', '.', '.']
['.', '.', '.', '.', '.', '.', '.', '.', '.', '.', '.', '.', '.', '.', '.', '.', '.', '.', '.', '.', '.', '.', '.', '.', '.', '.', '.', '.', '#', '#', '#', '#', '#', '#', '#', '.', '.', '.', '.', '.', '.', '.', '.', '.', '.', '.', '.', '.', '.', '.', '.', '.', '.']
[]
[]